오늘이라는 날은 두 번 다시 오지 않는다.	단테
내일이란 오늘의 다른 이름이다.	소포클레스
잃어버린 시간은 다시 돌아오지 않는다.	벤자민 프랭클린
어제에서 배우고, 오늘을 살고, 내일을 꿈꿔라.	알베르트 아인슈타인
오늘 할 수 있는 일을 내일로 미루지 말라.	벤자민 프랭클린
지금이 가장 중요한 순간이다.	에크하르트 톨레
미래는 오늘 만드는 것이다.	에이브러햄 링컨
하루는 작은 인생이다.	세네카
시간은 금이 아니라 금보다 소중하다.	톨스토이
오늘이 바로 당신 인생의 첫날이다.	찰스 디킨스
지금 하지 않으면 언제 하겠는가?	탈무드
하루를 소중히 여기는 사람이 인생을 소중히 여긴다.	안네 프랑크
기회는 오늘도 당신 앞을 지나간다.	나폴레옹
가장 낭비된 날은 웃지 않은 날이다.	니콜라스 샹포르
시간은 우리 모두에게 공평하다.	헨리 포드
지나간 시간은 다시 오지 않는다.	세네카
하루라도 성실하지 못하면 그 하루는 잃어버린 것이다.	톨스토이
오늘을 잡아라(Carpe Diem).	호라티우스
미래는 지금의 행동 위에 서 있다.	헤밍웨이
오늘 걷지 않으면 내일은 뛰어야 한다.	프랭클린
오늘이라는 날은 선물이다. 그래서 Present라 부른다.	빌 킨
시간을 지배하는 자가 인생을 지배한다.	프랜시스 베이컨
어제는 역사, 내일은 미스터리, 오늘은 선물이다.	엘리너 루즈벨트
가장 좋은 시간은 바로 지금이다.	달라이 라마
하루의 계획은 아침에 달려 있다.	중국 속담
오늘을 이르는 태도가 내일의 운명을 만든다.	오프라 윈프리
지금 이 순간에 당신의 모든 것이 있다.	톨레
미래를 바꾸려면 오늘을 바꿔라.	스티븐 코비
하루라도 배움을 쉬면 인생이 늙는다.	공자
중요한 것은 오늘 무엇을 했는가다.	존 F. 케네디
오늘 준비하지 않으면 내일은 후회로 가득할 것이다.	세네카
오늘의 선택이 미래를 디자인한다.	스티븐 코비
날마다 조금씩, 그러나 꾸준히.	탈무드
시간은 오래지만, 인생은 짧다.	시솝
하루의 끝은 새로운 시작의 문이다.	익명
지금의 나태함이 내일의 후회를 만든다.	격언
어제를 후회하고 내일을 걱정하며 오늘을 버리지 마라.	익명
바로 지금이 당신의 인생을 바꿀 순간이다.	짐 론
오늘 할 일을 내일로 미루지 말라.	케네디
하루하루는 서툴지만, 인생은 완성된다.	리처드 바크
미래는 오늘 시작된다.	교황 요한 바오로 2세
지금이 삶이다. 어제도 아니고 내일도 아니다.	마커스 아우렐리우스
어제보다 나은 오늘을 만들면 내일은 자연히 밝아진다.	존 맥스웰
시간은 당신을 기다려주지 않는다.	버지니아 울프
오늘을 포기하는 사람은 내일을 얻지 못한다.	괴테
지금의 한 걸음이 내일의 천 걸음이다.	일본 속담
하루가 모여 인생이 된다.	존 맥스웰
시간을 두려워하지 말고, 시간을 사랑하라.	파블로 피카소
어제의 자신보다 나아지면 된다.	탈무드
시간이 없다고 말하는 사람ほど 시간을 낭비한다.	톨스토이
지금 행동하는 것이 가장 강력한 전략이다.	마이클 조던
지금을 잡는 자가 미래를 지배한다.	나폴레옹
오늘의 태만은 내일의 불행이다.	러시아 속담
과거를 너무 보면 미래를 잃는다.	윈스턴 처칠
가장 늦은 것이 가장 빠른 것이다. 지금 시작하라.	아프리카 속담
지금의 작은 습관이 미래의 큰 성과를 만든다.	제임스 클리어
오늘이 있어야 내일도 있다.	한국 속담
오늘의 노력 없이는 내일의 성공도 없다.	에디슨
시간관리란 결국 자기관리다.	피터 드러커
어제는 지나갔고, 내일은 아직 오지 않았다. 오늘만이 당신 것이다.	부처
시간을 아끼는 것이 성공의 첫걸음이다.	디즈레일리
의미 없는 하루는 인생을 서서히 잠식한다.	톨스토이
내일의 행복은 오늘의 선택에서 시작된다.	헬렌 켈러
오늘을 살아라. 어제는 지나갔고 내일은 보장되지 않았다.	조안 바에즈
하루라도 게으르면 그만큼 인생에서 뒤처진다.	삼국지
시간이 흐른다고 모든 것이 해결되진 않는다.	마거릿 대처
오늘을 정복하면 내일은 자연히 따라온다.	처칠
지금 이 순간의 선택이 당신의 운명을 바꾼다.	아리스토텔레스
시간은 칼보다 강하다.	일본 속담
오늘이라는 날은 창조의 시간이다.	파울로 코엘료
순간을 잡는 자가 인생을 잡는다.	톨레
시간은 가장 공정한 재산이다.	윌리엄 펜
지금이야말로 최선의 시작이다.	에픽테토스
시간은 우리에게 가장 귀한 스승이다.	존 러스킨
하루가 모여 평생이 된다.	격언
내일이 오늘보다 나아지길 원한다면, 오늘을 바꿔라.	짐 론
시간은 당신이 어떻게 쓰느냐에 따라 가치가 달라진다.	브라이언 트레이시
오늘의 선택이 인생을 만든다.	헨리 디비드 소로
지금의 작은 결단이 인생을 바꾼다.	그레고리 맥기언
지금 행동하지 않으면 기회는 떠난다.	셰익스피어
하루를 헛되이 보내지 말라. 인생은 짧다.	셰익스피어
지금 이 순간을 사랑하라.	톨레
오늘의 한 걸음이 내일의 확신이 된다.	캐런 램
내일을 꿈꾸는 사람은 오늘을 낭비하지 않는다.	케네디
시간을 사랑하는 자가 성공한다.	토머스 제퍼슨
오늘을 지키면 미래도 지켜진다.	탈무드
하루의 시작은 마음가짐에서 온다.	에픽테토스
시간이란 우리가 가장 원하는 것이지만 가장 잘 쓰지 못하는 것이다.	윌리엄 펜
오늘을 살지 않으면 영원히 살 수 없다.	나탈리 게인즈버러
현재를 소유한 사람이 모든 것을 가진 사람이다.	괴테
시간은 모든 상처를 치유하지 않는다. 행동이 치유한다.	루이스 캐럴
오늘의 나태함이 내일의 불행을 부른다.	헤즐릿
오늘의 노력은 내일의 나를 만든다.	존 맥스웰
미래를 향한 가장 좋은 준비는 오늘 최선을 다하는 것이다.	잭슨 브라운
어제의 후회는 오늘의 지혜가 된다.	로버트 콜리어
인생의 결정적 순간은 대부분 지금이다.	나심 탈레브
내일을 위해 오늘을 희생하지 말라.	파울로 코엘료
시간은 모든 것을 시험한다.	플루타르크
오늘은 미래의 열쇠이다.	교황 요한 바오로 2세
오늘의 태도가 내일의 성공을 결정한다.	에디슨
오늘이라는 시간을 사랑하라.	레오 버스카글리아
하루를 설계하는 자가 인생을 설계한다.	짐 론
지금이 아니면 결코 아니다.	셰익스피어
미래는 오늘의 연장선이다.	톨스토이
하루의 가치를 알면 인생의 가치를 안다.	괴테
시간은 우리가 가진 가장 공정한 재산이다.	윌리엄 펜
오늘을 최고의 날로 만들어라.	해롤드 힐
지금 행동하는 자가 승리한다.	알렉산더 대왕
하루의 시작은 기적을 품고 있다.	루이스 헤이
오늘의 실천이 미래의 기적을 만든다.	테오도르 루스벨트
어제에 머물면 내일을 잃는다.	처칠
순간을 잡아라, 그 순간이 당신의 것이다.	에머슨
하루는 당신을 바꿀 수 있다.	파울로 코엘료
하루 1%의 변화가 인생을 바꾼다.	제임스 클리어
오늘의 작은 승리가 내일의 큰 승리다.	마틴 루터 킹
시간은 당신에게 가장 소중한 선물이다.	레오 톨스토이
오늘을 지혜롭게 써라.	마거릿 풀러
어제의 당신보다 나아지자.	탈무드
지금의 선택이 운명을 만든다.	오스카 와일드
하루는 많은 가능성을 품고 있다.	익명
오늘 시작하지 않으면 내일은 없다.	조지 허버트
오늘을 열심히 살면 미래가 당신을 도울 것이다.	에머슨
내일은 약속되지 않았다.	조 코터
지금이야말로 시작할 시간이다.	루이스 캐럴
시간은 당신의 친구가 될 수도, 적이 될 수도 있다.	브라이언 트레이시
오늘을 붙잡아라.	호라티우스
하루는 다시 오지 않는다.	일본 속담
오늘의 선택은 내일의 삶이다.	로버트 콜리어
내일이 두려운 이유는 오늘을 헛되이 썼기 때문이다.	격언
오늘의 노력 없이 내일을 기대하지 말라.	에디슨
시간을 다스리지 못하면 인생도 다스릴 수 없다.	피터 드러커
오늘을 바꾸면 인생이 바뀐다.	짐 론
시간의 가치는 지나가면 더 커진다.	세네카
하루를 소중히 하라. 그것이 곧 인생이다.	부처
지금은 다시 오지 않는다.	아우렐리우스
오늘은 과거의 결과이며, 미래의 원인이다.	에머슨
오늘의 태도는 내일의 삶이다.	나폴레옹
오늘을 위해 살아라.	헨리 소로
지금의 한마디가 내일의 운명을 바꾼다.	탈무드
시간은 인간에게 주어진 가장 평등한 자원이다.	토머스 제퍼슨
어제를 잡고 있으면 두 손이 바빠 오늘을 잡지 못한다.	중국 속담
인생은 순간의 연속이다.	마커스 아우렐리우스
오늘의 기회는 오늘만 존재한다.	잭 웰치
시간이란 우리가 만든 가장 큰 환상이다.	아인슈타인
하루가 당신을 만든다.	존 C. 맥스웰
내일의 성공은 오늘의 용기에서 나온다.	노먼 빈센트 필
현재는 선물이다.	오프라
지금을 붙잡는 것이 곧 지혜다.	톨스토이
오늘을 사랑하는 사람은 행복한 사람이다.	괴테
시간은 인생의 통화다.	짐 론
오늘 최선을 다하라.	잭슨 브라운
하루의 의미는 당신이 부여한 만큼이다.	에머슨
내일을 생각하면 오늘의 행동이 바뀐다.	윈스턴 처칠
지금 하지 않으면 결코 하지 못한다.	셰익스피어
시간은 당신이 만들어가는 것이다.	마거릿 대처
지금 당신이 하는 일이 바로 인생이다.	찰스 부코스키
오늘의 선택이 당신을 만든다.	소로
어제가 아니라 오늘이 중요하다.	윌리엄 제임스
지금 시작하면 미래가 달라진다.	짐 론
오늘이 없다면 내일도 없다.	톨스토이
하루는 다시 오지 않는 기회다.	일본 격언
오늘의 집중이 미래의 자유를 만든다.	티모시 페리스
매일이 기적이다.	루이스 헤이
오늘의 태도는 인생 전체의 태도다.	에머슨
시간을 훔쳐 쓰지 말라. 정면으로 마주하라.	마커스 아우렐리우스
내일을 위해 오늘 심어라.	성경
오늘이 당신의 미래다.	익명
하루의 시작은 인생의 시작이다.	파울로 코엘료
오늘이라는 시간 속에서만 변화가 시작된다.	톨레
오늘의 열정이 내일의 기적을 만든다.	헬렌 켈러
지금 하지 않으면 후회는 영원하다.	괴테
시간은 당신의 잠재력을 드러낸다.	피터 드러커
하루를 붙잡아라.	라틴 격언
지금의 마음이 내일의 현실이다.	루이스 헤이
오늘이라는 시간은 가장 진실한 선물이다.	오프라 윈프리
오늘은 어제의 꿈이 만든 것이다.	칼릴 지브란
오늘의 행동 없이 내일의 변화는 없다.	제임스 클리어
시간을 지배하는 자가 인생을 지배한다.	베이컨
오늘의 작은 발걸음이 미래의 큰 길이 된다.	스티븐 코비
지금의 결심이 당신을 만든다.	브라운
하루는 당신이 만드는 작품이다.	익명
내일은 오늘의 복사본이다.	톨스토이
지금을 놓치면 내일이 없다.	톨레
시간은 가장 훌륭한 조각가다.	프랑스 격언
오늘의 마음은 내일의 몸이다.	동양의학 명언
지금 바로 시작해야만 꿈은 현실이 된다.	월트 디즈니
시간은 당신이 어떻게 살아왔는지 말해준다.	플루타르크
오늘을 살아라. 내일은 누구에게도 약속되지 않았다.	성경
오늘이라는 날은 축복이다.	헬렌 켈러
하루는 짧지만 충분하다.	스티븐 킹
시간을 헛되이 보내지 마라. 삶을 잃게 된다.	존 러스킨
오늘이 당신의 인생을 만든다.	악셀 무어
지금을 붙잡아라. 그것이 유일한 것이다.	마크 트웨인
오늘 일찍 일어나는 자가 내일을 얻는다.	벤자민 프랭클린
오늘은 다시 오지 않는다. 그러니 사랑하라.	파울로 코엘료
하루의 태도는 인생을 비춘다.	익명
내일은 오늘의 결과일 뿐이다.	아우렐리우스
지금 이 순간이 바로 삶의 정수다.	톨레
오늘의 선택이 내일의 자유를 만든다.	스티븐 코비
오늘을 변화시키면 인생이 바뀐다.	짐 론